她	tln
趣	qft
二	eha
壬	rsp
右	yru
时	ubo
础	imu
噢	opk
醅	piy
吖	alk
鸽	grr
盉	heh
玖	jzw
渴	kld
崽	zuu
孝	xll
丛	cjr
遮	vrz
叭	blk
倪	nbr
嘛	mlk
肮	auo
袄	axp
扒	blf
宝	bxb
栟	bem
泵	bfu
邦	buf
毕	btb
病	bwb
摽	blf
泊	bed
卑	bip
曹	cic
苍	cuc
瓷	cbd
惭	cpx
锉	cpj
存	cfu
德	der
党	dpx
堤	djt
儋	dnr
疔	deb
簟	dav
鲷	dmy
惰	dpx
迭	dsz
恫	dyx
蠹	dhg
怼	dfy
囤	drk
锋	fcj
邡	fuf
篚	fjv
膏	gqw
盖	goy
冈	guk
玕	gnw
官	gdb
骨	gmg
簋	gvv
钩	gxj
孩	hdz
盒	her
桁	hfm
颔	har
荒	hwc
惑	hpg
擐	hcf
纮	hjs
祜	hhp
徽	htr
浑	hfd
厚	hri
叉	ily
珵	ifw
嗤	ijk
颤	iaw
惙	ipx
涌	ynd
琡	ihw
圌	iwk
近	jvz
及	jbp
奖	jul
检	jpm
嚼	juk
揭	jkf
九	jzp
镌	jdj
冏	jek
惧	jfx
架	jxl
畯	jrt
犒	kvn
磕	kru
扛	kwf
砍	kou
𫛭	kbq
括	kpf
圐	kak
揦	luf
檩	lxm
耢	lvl
坜	ltt
领	lwr
晾	leo
络	lps
烈	lqd
溜	lzd
鹭	lhz
檑	lrm
娄	lam
嘛	mlk
贸	mvp
檬	mfm
密	mtb
万	waa
湄	mrd
哪	nmk
昵	nto
嬢	nin
袅	nln
弩	nmn
噢	opk
鸥	oxq
贫	pcf
排	pdf
抨	pcf
披	pjf
爿	ppv
飘	pmx
酺	ply
期	qjc
鲭	qey
骞	qrb
佺	qor
穹	qkb
曲	qsk
忍	ror
瓤	rwy
爇	rpc
冗	rnb
嬬	rln
搔	sqf
塞	sbb
涩	sid
泗	std
蔌	shc
碎	sfu
飕	sxf
淘	tid
汰	tod
替	ttf
谭	tpy
托	tsf
嗵	tkk
吐	tmk
嗄	uik
沈	uod
升	ucp
食	ubr
苫	uac
霜	uwy
疏	uav
艏	uzv
招	vqf
谪	vey
砧	veu
吱	vjk
状	vel
卓	vlb
珠	vaw
咒	vrk
闻	wsm
瓮	wfg
挝	wpf
五	wma
辛	xhl
夕	xjp
相	xym
嫌	xvn
箫	xmv
休	xzr
凶	xpk
削	xmx
许	xsy
讯	xry
吖	alk
吟	yck
爻	yix
杨	ywm
咦	ybk
腌	yno
鹰	yeg
唷	ypk
咏	ynk
竽	ymv
繇	yav
咂	zlk
兹	zjb
酂	zan
作	zpr
宗	zkb

唉	aoku/
碍	aouc/
砹	aoux/
毐	autm/
嗳	auky/
蔼	aucr/
霭	auyr/
嗌	aokm/
叆	aoyy/
皑	adbj/
案	aabm/
胺	aaon/
鞍	angn/
盦	anrm/
垵	antn/
犴	aaqg/
𩽾	anyn/
敖	aifw/
鳌	aify/
螯	aifi/
拗	avfl/
獒	aifq/
鏊	avfj/
鏖	ailj/
骜	avfm/
聱	aife/
奡	avbl/
嶅	aifu/
拔	bufy/
爸	bifb/
巴	blsl/
捌	blfd/
魃	bugy/
鲃	blyb/
鲅	biyy/
菝	bucy/
朳	blmb/
殡	bvdb/
濒	bhdy/
摈	bvfb/
玢	fewf/
槟	bhmb/
抱	bvfb/
堡	bxrt/
煲	bqrh/
暴	bvou/
刨	bvbd/
褒	bqym/
胞	bqob/
葆	bxcm/
苞	bqcb/
鸨	bxbn/
炮	pvhb/
雹	biyb/
龅	bqvb/
趵	bvzu/
掰	bbuu/
捭	bufu/
伯	berb/
夯	hudl/
迸	bfzk/
榜	bpmf/
梆	bume/
搒	bdff/
鼻	bbzw/
避	btzx/
臂	btuo/
弊	btxc/
璧	btuy/
敝	btxw/
匕	bgpv/
毙	btbb/
俾	bgru/
鄙	bgke/
吡	bgkb/
弼	btgb/
痹	btbw/
妣	bgnb/
髀	btgu/
屄	bjub/
箅	btvw/
滗	btdm/
嬖	btun/
芘	bgcb/
沘	bgdb/
裨	btpu/
篦	btvb/
邲	btbe/
萆	btcu/
薜	btcx/
跸	btzu/
珌	btwb/
辟	btux/
佖	btrb/
荸	bbcz/
筚	btvu/
佛	ferf/
觱	btwy/
馝	bthb/
鲾	bjyt/
坒	btbt/
拌	bafb/
斑	bnww/
扮	baff/
扳	bnfy/
癍	bnbw/
柈	bamb/
攽	bnfw/
瘢	bnbu/
𨭉	bnwj/
秉	bwqr/
屏	pnuk/
槟	bhmb/
邴	bwbe/
栟	bemk/
遍	bazc/
辨	baxl/
卞	bawb/
煸	brhc/
弁	basc/
辫	baxs/
萹	brcc/
忭	baxb/
碥	bpuc/
𨚕	base/
杓	bmmu/
镳	bmjh/
骉	bmmm/
熛	bmhu/
幖	bmju/
俵	blry/
飑	bmfb/
脿	bloy/
拨	bpfy/
搏	befc/
勃	beul/
钵	bpjb/
亳	bewq/
柏	bumb/
孛	bkuz/
钹	bejy/
渤	bedl/
镈	bejc/
僰	beur/
擘	bguu/
浡	bedz/
舶	bevb/
嶓	bput/
膊	beoc/
哱	bpkz/
砵	bpub/
踣	bezk/
簸	bivp/
菠	bpcp/
鹁	beun/
檗	bgum/
蕃	bpct/
艴	befb/
趵	bvzu/
礴	beuc/
欂	bemc/
𬭛	bpjp/
鳖	bkxy/
蹩	bsxz/
癿	bsbv/
簿	bhvc/
卜	bmld/
哺	bmkf/
瓿	bhlw/
埔	pmtf/
埗	bhtu/
𬷕	bmfn/
贝	bkkr/
辈	bkfi/
邶	bkbe/
孛	bkuz/
碚	bkuk/
琲	bkwf/
惫	bkwx/
鹎	bipn/
棓	bkmk/
椑	bimu/
褙	bkpo/
糒	bkmy/
臂	btuo/
鐾	bkuj/
鞁	bkgp/
糙	cqmk/
嘈	ciko/
芔	hfcc/
蔡	cocu/
彩	cucp/
嶒	cfuo/
伧	curv/
磁	cbuy/
辞	cbux/
雌	cbvv/
慈	cbbx/
泚	cgdb/
疵	cjbb/
差	iiyg/
茈	cbcb/
兹	zjby/
佽	ctrq/
鹚	cbbn/
莿	ctcd/
𫚖	cgvy/
残	cpdj/
粲	cadm/
䅟	cohp/
挫	cpfr/
措	cpfo/
撮	csfy/
嵯	clug/
鹾	clbg/
撺	cdfi/
镩	cdji/
枞	ckmr/
璁	ckwx/
苁	ckcr/
徂	clrq/
卒	zlwu/
毳	cfmm/
悴	cfxu/
漼	cvdv/
榱	ctmv/
搭	dlfk/
嗒	dlkk/
跶	dlzd/
笪	duvd/
靼	dugd/
溚	dudk/
鿎	duud/
𫟼	dujd/
纛	dvfx/
蹈	dxzj/
捯	difd/
忉	dqxd/
舠	dqvd/
待	dorc/
贷	dorb/
袋	dory/
黛	dorh/
岱	doru/
迨	dozk/
呔	dbkt/
绐	dosk/
大	diar/
垈	dort/
凳	dfbj/
戥	dyog/
嶝	dfub/
菪	ddcu/
𣗋	dpmx/
笛	dbvy/
递	dtzd/
氐	dgud/
骶	dggu/
邸	dgue/
碲	dtuj/
籴	dbrm/
砥	dguu/
鞮	djgz/
涤	dbdm/
荻	dbch/
菂	dtcu/
娣	dtnd/
诋	dgyu/
柢	dgmu/
杕	dtmd/
坻	dgtu/
踶	dtzz/
媂	dtnj/
提	tbfz/
蹢	dbzg/
的	drbu/
玓	dtwu/
𤧛	dtwj/
𬱖	dbyy/
旦	daoa/
啖	dakh/
掸	dofu/
澹	dadk/
聃	dner/
殚	dndu/
憺	daxk/
膻	daod/
疍	dazd/
瘅	dnbu/
眈	dnoe/
赕	dobh/
郸	dnbe/
疸	dobd/
𫢸	daru/
腚	dwoz/
锭	dwjz/
啶	dwkz/
酊	deyd/
殿	dauu/
颠	druy/
掂	drfv/
癫	drby/
奠	dabd/
靛	dafz/
淀	dadz/
癜	dabu/
琔	dawz/
叼	dmkd/
雕	dmkv/
貂	dmvk/
碉	dmuk/
铫	yijv/
铞	dljj/
汈	dmdd/
朵	dljm/
铎	dljf/
踱	dlzy/
咄	dski/
埵	dltt/
哚	dlkm/
饳	dpui/
㙍	dsty/
谍	dsym/
垤	dstt/
蹀	dszm/
𫶇	dsuj/
耑	ddue/
簖	dcvj/
冻	dydd/
鸫	dkdn/
硐	dyuk/
岽	dkud/
胨	dyod/
睹	dmoo/
犊	dlnd/
椟	dlmd/
渎	dldd/
阇	damo/
厾	davq/
黩	dlld/
髑	dlgi/
𬭊	dhjt/
墩	dgtw/
遁	drzo/
趸	dowz/
镦	dgjw/
蹾	dgzw/
砘	drut/
窦	drbd/
讹	eeyb/
鳄	eiyk/
鄂	eike/
蛾	eeiw/
颚	eiky/
轭	eiiv/
屙	eruk/
锷	eijk/
鹗	eikn/
峨	eeuw/
萼	eick/
垩	eiyt/
噩	eiwk/
哦	oekw/
婀	ernk/
苊	eicv/
𫫇	eikx/
洱	eude/
鲕	ekye/
耏	ekep/
陑	ekee/
垡	furt/
粪	fomg/
焚	fsmh/
奋	fodt/
偾	forb/
棻	fecm/
棼	fsmf/
鲼	foyb/
瀵	fodg/
翂	fexf/
坋	fotf/
𣸣	fsdb/
丰	fcsl/
凤	ffjy/
蜂	fcif/
沣	fcdf/
酆	fcue/
砜	fcuf/
崶	fcuc/
赗	ffbo/
鲂	fwyf/
肪	fwof/
牥	funf/
范	facv/
番	fnct/
帆	fnjf/
樊	fpmd/
矾	fpuf/
幡	fnjt/
燔	fpht/
氾	fpdv/
蘩	fpcx/
蹯	fpzt/
墦	fptt/
𬸪	fpcn/
夫	faer/
福	flpt/
父	fhbx/
赋	fhbv/
弗	flgl/
伏	flrq/
敷	fafw/
傅	fhrc/
釜	fmfb/
斧	fmfj/
腹	fhow/
浮	fldz/
拂	flff/
腐	fmgr/
俘	flrz/
腑	fmoc/
辐	flit/
孚	flvz/
佛	ferf/
肤	faof/
阜	fhpu/
凫	flnj/
祓	flpy/
芣	flcb/
鄜	fale/
涪	fldk/
黻	flyy/
苻	flcc/
拊	fmfc/
郛	flve/
簠	fmvm/
绂	flsy/
宓	mtbb/
茯	flcq/
赙	fhbc/
莩	flcz/
趺	fazf/
茀	flcf/
蝮	fhiw/
稃	fahz/
匐	flbt/
罘	flsb/
驸	fhmc/
怫	flxf/
袱	flpq/
洑	fldq/
鲋	fhyc/
菔	flcy/
滏	fmdb/
芾	flcj/
幞	fljf/
咐	fhkc/
绋	flsf/
蚨	flif/
韨	flwy/
琈	flwz/
垺	fltz/
讣	fhyb/
蜉	fliz/
砆	fauf/
㕮	fmkf/
㳇	fhdf/
𫖯	fmvy/
肥	frob/
斐	fjfw/
吠	fkkq/
啡	fikf/
腓	frof/
淝	frdb/
蜚	fjfi/
朏	fjoi/
诽	fjyf/
翡	fjfx/
芾	flcj/
棐	fjfm/
剕	fkfd/
𬴂	fimf/
噶	gukr/
咖	klkk/
旮	gljo/
锆	gvjk/
郜	gvne/
槔	gqmu/
羔	gqyh/
槁	gxmk/
筶	gvvk/
钙	gojg/
𬮿	goej/
歌	grkq/
咯	kmkk/
阁	gemk/
镉	gejg/
革	gecu/
嗝	gekg/
胳	grok/
盖	goym/
疙	grbv/
饹	lruk/
仡	grrv/
合	herk/
虼	giiv/
塥	getg/
赓	gcgb/
鲠	gyyg/
鹒	gcgn/
罡	gusv/
矼	guug/
扛	kwfg/
冮	gudg/
㭎	gumx/
鿍	gdtf/
柑	gnmg/
苷	gncg/
橄	gomw/
酐	gnyg/
鳡	goyx/
泔	gndg/
坩	gntg/
旰	gaog/
澉	godw/
掴	ggfy/
洸	gwdg/
椁	glmz/
崞	gsuz/
呙	gskn/
帼	gljy/
蜾	glig/
埚	gstn/
𬇹	gldy/
冠	gdbc/
贯	gcmb/
毌	gcml/
掼	gcfb/
琯	gswl/
鳏	gdyx/
筦	gsvy/
涫	gcdl/
莞	wocy/
鳤	gsyl/
蒄	gdcc/
宫	gkbk/
功	gkgl/
汞	gngu/
贡	gygb/
恭	gkgx/
巩	gngf/
䢼	gkge/
硔	gnug/
蛊	gmim/
咕	gakg/
瞽	gmto/
菰	gacg/
辜	gagx/
毂	gmtu/
觚	gadg/
酤	gayg/
锢	ghjg/
崮	ghug/
堌	ghtg/
蛄	gaig/
汩	gmdo/
鹘	hlgn/
牯	gmng/
嘏	gmgy/
鹄	hlnn/
痼	ghbg/
羖	gmyu/
瀔	gmdu/
臌	gmov/
馉	gmuo/
牿	ghnk/
蓇	gaco/
𦙶	gmog/
桂	gfmt/
珪	gtwt/
邽	gtte/
鲑	gtyt/
刿	gfud/
桧	gfmy/
鳜	gfyq/
鬶	gtfg/
宄	gvbj/
皈	gtby/
炅	jeoh/
姽	gvnv/
筀	gfvt/
剐	ggkd/
鸹	gsun/
衮	goyg/
购	grbg/
彀	grtu/
枸	jsmj/
姤	grnk/
雊	grjv/
句	jfbk/
笱	gzvj/
嚎	hiku/
蚝	hiim/
蒿	hqck/
毫	hiwm/
皞	hvbu/
濠	hidu/
灏	hvdy/
鄗	hvwe/
淏	hvdt/
颢	hvoy/
嚆	hqkk/
嗐	hokk/
咳	kekr/
合	herk/
呵	hrkk/
阖	hemm/
褐	hipr/
颌	hery/
郃	here/
涸	hedg/
鹖	heon/
貉	hevk/
吓	xxkx/
壑	hibt/
龢	herh/
熇	hihk/
菏	heck/
阂	hemr/
隺	hibv/
鞨	hegr/
𬌗	heyk/
珩	hfwd/
鸻	hfrn/
行	xnrd/
沆	hddj/
汗	hadg/
函	hpku/
焓	hphk/
罕	hobg/
涵	hpdu/
翰	haux/
憾	haxx/
瀚	hadx/
晗	hpok/
捍	hafg/
邗	hpge/
暵	haot/
顸	hngy/
撖	hafw/
浛	hpdk/
虷	gnig/
㘎	hokw/
崡	hpuu/
嵅	hpuk/
蔊	hocg/
篁	hbvw/
幌	hujg/
恍	huxg/
潢	hbdb/
湟	hbdw/
肓	hwwo/
锽	hbjw/
惶	hbxw/
鳇	hbyw/
癀	hbbb/
蟥	hbib/
瑝	hbww/
㿠	hebg/
𨱑	hbjb/
豁	hsbg/
伙	hlrh/
藿	hpcv/
钬	hljh/
濩	hpdy/
夥	hlgx/
嚄	hsky/
漷	hlde/
劐	hscd/
佸	hlru/
锪	hsjx/
㸌	hphv/
欢	hdyq/
涣	hcdr/
洹	hodd/
圜	hoky/
郇	xfbe/
鲩	hcyy/
宦	hcbi/
逭	hczl/
缳	hosy/
鹮	hosn/
澴	hody/
镮	hojy/
漶	hcdx/
痪	hcbr/
㬊	hsoy/
荁	hocd/
𤩽	howq/
虹	hjig/
鸿	hjdn/
泓	hjds/
吽	hkkn/
訇	hkbk/
蕻	hjcg/
唝	hnkb/
谼	hjgg/
𬭎	hjjs/
湖	hldo/
和	hehk/
沪	hhdh/
弧	hlgg/
唬	hmkj/
斛	hldd/
核	hemr/
瑚	hlwo/
瓠	hhdg/
縠	hltu/
扈	hhhb/
烀	hahh/
煳	hlho/
惚	haxx/
鹘	hlgn/
唿	hakx/
鹱	hhny/
鳠	hhyy/
琥	hmwj/
淴	hadx/
浒	hmdw/
醐	hlyo/
槲	hlmd/
囫	hlkw/
戽	hhhd/
嫭	hhnh/
轷	haih/
猢	hlqo/
昒	haow/
喙	hfku/
慧	hffx/
恢	htxh/
卉	hfuc/
蕙	hfcx/
秽	hfhx/
麾	htgm/
晦	hfom/
诲	hfym/
荟	hfcy/
浍	hfdy/
洄	hwdk/
翚	htxi/
翙	hfux/
咴	htkh/
珲	hfwi/
蛔	hwik/
彗	hffe/
哕	hfkx/
诙	htyh/
溃	kfdb/
蟪	hfix/
桧	gfmy/
烠	hwho/
硊	hfuv/
㧑	htfw/
𬤝	hfyx/
𬭬	hfje/
华	htru/
骅	htmu/
觟	hgdt/
溷	hrdu/
馄	hfub/
诨	hryi/
碈	hguo/
喉	haku/
候	hrru/
垕	hrit/
逅	hrzk/
郈	hrie/
茬	iuct/
搽	iufm/
槎	iumg/
岔	iifu/
檫	iumu/
杈	ilmi/
锸	iljj/
诧	iiyq/
馇	ilud/
喳	vlkd/
𥻗	iumd/
嘲	iiko/
焯	iqhu/
豺	idvc/
撤	iifw/
砗	irui/
嗔	iekb/
谌	isyb/
瞋	ieob/
忱	isxe/
煁	ishb/
榇	iomm/
疢	iobh/
棽	iemv/
郴	ieme/
程	ifhw/
秤	ifhp/
丞	ifla/
枨	ifmi/
埕	iftw/
骋	iymk/
澂	ifdw/
琤	icwy/
偁	icrr/
蛏	icit/
赪	icib/
噌	ccko/
酲	ifyw/
柽	icmt/
瞠	icot/
珹	ifwi/
晟	ifoi/
铛	icje/
憕	ifxb/
尝	iwxy/
昌	iuoo/
敞	ipxw/
鬯	idkb/
怅	idxi/
倡	idro/
嫦	iwnj/
氅	ipxm/
伥	iuri/
鲳	iuyo/
菖	iuco/
徜	iwrk/
鲿	iwyy/
惝	ipxk/
敕	ituw/
翅	itvx/
豉	igdv/
叱	itkb/
笞	ijvk/
哧	ijki/
饬	itul/
褫	igpj/
魑	ijgn/
摛	ijfn/
鸱	ijun/
瘛	itbx/
漦	ibwu/
墀	ibtn/
茌	ibct/
眵	ijox/
篪	ibvj/
傺	itru/
踟	ibzk/
胣	igoy/
痓	itbt/
搀	infd/
澶	ipdd/
蟾	ipik/
襜	inpk/
谄	ioyj/
镡	tpju/
刬	iajd/
辿	inzu/
巉	iput/
羼	iauy/
廛	ipgt/
潺	ipdz/
梴	inmv/
孱	ipuz/
骣	iomz/
镵	ipjt/
瀍	ipdt/
冁	ioby/
搋	igfj/
疮	iwbv/
逴	iszu/
喘	iske/
翀	ikxv/
艟	ikvl/
珫	ikwy/
漴	ijdu/
㳘	ikdy/
褚	impo/
杵	immw/
雏	ildv/
橱	ilmc/
畜	xfxt/
刍	ilde/
俶	ihry/
楮	immo/
矗	ihuq/
滁	ildm/
樗	iamk/
憷	ihxz/
斶	ihji/
摴	iafk/
蜍	ilim/
濋	imdz/
蹰	ilzc/
䢺	iaie/
𬺓	imvz/
棰	iwmt/
春	igio/
唇	ifik/
瑃	igwo/
䲠	igyo/
筹	iavc/
稠	iahk/
雠	iary/
俦	iarc/
椆	iamk/
犨	ixrn/
踌	iazc/
侴	izrd/
金	jhrb/
今	jhrv/
尽	jvid/
锦	jxjj/
浸	jvdy/
谨	jxyw/
槿	jxmw/
襟	jhpu/
矜	jhmv/
瑨	jvwo/
噤	jvku/
溍	jvdo/
觐	jvcj/
祲	jvpy/
浕	jvdd/
荩	jvcd/
殣	jvdw/
珒	jhwy/
廑	jxgw/
琎	jvwj/
卺	jxlv/
既	jtgw/
鸡	jjyn/
极	jbmj/
系	xtpx/
继	jtsm/
计	jtyu/
给	gjsk/
技	jtfv/
击	jjfk/
纪	jtsj/
寂	jtby/
积	jjhv/
暨	jtgd/
脊	jgro/
疾	jbbu/
箕	jjvb/
激	jjdw/
济	jtdq/
叽	jjkj/
饥	jjuj/
冀	jtbg/
绩	jtsb/
棘	jbuu/
藉	jbco/
稷	jthw/
妓	jtnv/
汲	jbdj/
蓟	jtcd/
伋	jbrj/
赍	jjub/
髻	jtek/
殛	jbda/
鲫	jtye/
伎	jtrv/
稽	jjho/
偈	jtrr/
畸	jjtk/
圾	jjtj/
霁	jtyq/
嫉	jbnu/
讥	jjyj/
奇	qbdk/
笈	jbvj/
骥	jtmg/
嵴	jbuo/
唧	jjke/
齑	jjqj/
乩	jjvv/
戢	jbge/
畿	jjgt/
芰	jtcv/
嵇	jjhu/
洎	jtdz/
罽	jtsd/
笄	jjvk/
楫	jbme/
跻	jjzq/
麂	jglj/
垍	jttz/
姞	jbnk/
荠	jtcq/
蕺	jbce/
屐	jjuv/
跽	jtzx/
漈	jtdu/
悸	jtxz/
缉	jjse/
剞	jjdd/
佶	jbrk/
惎	jtcx/
耤	jblo/
虮	jgij/
芨	jjcj/
瘠	jbbo/
蹐	jbzo/
蒺	jbcu/
墼	jjit/
鹡	jbrn/
㴔	jbdx/
枅	jjmk/
𪟝	jtfl/
𫌀	jjpb/
𫓯	jjjt/
𫓹	jjjb/
𬯀	jjeq/
𬶨	jtgy/
颈	jwjy/
警	jwck/
茎	jecj/
荆	jecd/
竞	jwlx/
菁	jeco/
晶	jeoo/
靖	jwlo/
璟	jwwx/
胫	jwoj/
粳	jemg/
劲	jvjl/
旌	jefu/
泾	jedj/
丼	jwjd/
竫	jwly/
儆	jwrw/
憬	jwxx/
倞	jwrx/
靓	lefj/
鼱	jejo/
璥	jwww/
猄	jeqx/
䴖	jefn/
酱	jely/
姜	jyyn/
桨	julm/
浆	jylu/
疆	jygj/
缰	jysj/
鳉	jyyc/
豇	jydg/
洚	jedf/
强	qigi/
耩	julr/
弶	jegx/
茳	jycg/
煎	jrbh/
剪	jpbd/
简	jpvo/
舰	javj/
贱	jabj/
健	jary/
歼	jrdq/
荐	jacz/
溅	jadj/
拣	jpfd/
僭	jaro/
坚	jrlt/
鉴	jalj/
涧	jado/
践	jazj/
蹇	jpbz/
艰	jryg/
翦	jpbx/
菅	jrcl/
俭	jprq/
柬	jpur/
缣	jrsj/
锏	jpjo/
睑	jpoq/
鞬	jrgy/
謇	jpbk/
湔	jrdd/
踺	jazy/
犍	jrny/
槛	komm/
蒹	jrcj/
搛	jrfj/
鲣	jryt/
枧	jpmj/
鹣	jrjn/
楗	jamy/
暕	jpoj/
谫	jpyd/
趼	jpzk/
饯	jauj/
鞯	jrgz/
牮	jarn/
鳒	jryj/
胶	jmof/
浇	jmdw/
绞	jlsf/
轿	jlil/
蛟	jmif/
徼	jlrf/
骄	jmml/
礁	jmuh/
饺	jluf/
皎	jlbf/
郊	jmwe/
湫	qzdh/
姣	jmnf/
酵	jlyz/
校	xlmf/
滘	jldk/
鹪	jmrn/
醮	jlyh/
皦	jlbw/
艽	jmcj/
茭	jmcf/
峤	jlul/
璬	jlww/
侥	jlrw/
斠	jlfd/
皭	jlbc/
藠	jlcb/
噍	jlkh/
僬	jmrh/
恔	jlxf/
䴔	jmwn/
街	jkrt/
戒	jqgc/
介	jqrl/
捷	jsfz/
洁	jsdk/
芥	jqcj/
藉	jbco/
羯	jsyr/
颉	xsty/
桔	jsmk/
价	jxrj/
疖	jkbe/
孑	jsla/
诫	jqyc/
婕	jsnz/
疥	jqbj/
碣	jsur/
絜	jsfx/
劼	jstl/
拮	jsfk/
檞	jcmn/
骱	jqgj/
湝	jkdb/
楷	kumb/
蜐	jsil/
鲒	jsyk/
讦	jsyg/
喈	jkkb/
悈	jqxc/
岊	jsbu/
㛃	jsfn/
鸠	jzjn/
韭	jzfa/
舅	jojl/
咎	jowk/
臼	jopa/
鹫	jown/
疚	jobj/
氿	jzdj/
阄	jzmd/
桕	jomj/
隽	jcrn/
鹃	jdkn/
眷	jcjo/
锩	jsjv/
桊	jcjm/
扃	jphk/
颎	jeby/
掘	jifi/
角	jldy/
玦	jiwg/
噘	jukq/
攫	jify/
谲	jiyk/
抉	jifg/
傕	jirv/
桷	jimy/
觖	jidg/
獗	jiqq/
劂	jiid/
砄	jiug/
㵐	jidq/
𫔎	jijk/
𫘝	jimg/
局	jmuk/
居	jhug/
拒	jffj/
狙	jhqq/
钜	jfjj/
矩	jsuj/
遽	jfzu/
莒	jsck/
掬	jhfm/
驹	jhmj/
踞	jfzg/
桔	jsmk/
锔	jmjk/
苴	jhcq/
炬	jfhj/
咀	jskq/
椐	jhmg/
鞫	jhgk/
屦	jfun/
倨	jfrg/
雎	jhqv/
苣	jfcj/
疽	jhbq/
榉	jsmf/
飓	jffb/
窭	jfbn/
醵	jfyu/
龃	jsvq/
泃	jhdj/
砠	jhuq/
踽	jszy/
犋	jfnb/
澽	jfdu/
弆	jsqc/
䴗	jmon/
𬶋	jhyj/
价	jxrj/
佳	jdrt/
伽	jdrk/
驾	jxlm/
痂	jdbk/
镓	jdju/
颊	jcjy/
葭	jdcy/
郏	jcje/
瘕	jnby/
铗	jcjj/
戛	jcbg/
茄	qsck/
胛	jnoj/
槚	jnmb/
跏	jdzk/
袈	jdly/
泇	jddk/
𬂩	jdmj/
郡	jrye/
麇	jglh/
皲	jgbp/
莙	jgck/
龟	gtdd/
隽	jcrn/
葰	jrcw/
鲪	jgyk/
䐃	jroh/
咖	klkk/
咔	klkb/
㸆	kvhf/
锎	kbjk/
慨	kuxw/
闿	kumj/
锴	kujb/
忾	koxq/
剀	kuud/
嗑	kikm/
珂	krwk/
棵	krmg/
颏	krwy/
窠	krbg/
髁	krgg/
疴	krbk/
坷	kltk/
蝌	krid/
炣	klhk/
岢	kluk/
溘	kidm/
稞	krhg/
匼	krkk/
恳	kogx/
闶	kdmj/
堪	kntb/
龛	knrl/
阚	kamw/
戡	kncg/
莰	kocq/
衎	karg/
崁	kauq/
嵁	knub/
墈	katl/
磡	kaul/
郐	kfre/
侩	kfry/
匡	kwkw/
诳	kbyw/
眶	keow/
夼	kudi/
洭	kwdw/
硿	kyug/
骷	kagg/
夔	kwbw/
溃	kfdb/
馈	kfub/
愦	kfxb/
骙	kwmt/
跬	kvzt/
悝	ktxl/
戣	kwbg/
喟	kfko/
喹	kwkt/
蒉	kfcb/
岿	ktue/
暌	kwot/
𫠆	kvvy/
堃	kgft/
鹍	kgon/
醌	kgyb/
壸	koty/
抠	kxfq/
芤	kxcv/
喇	lmkd/
落	lpck/
旯	luoj/
蝲	liid/
砬	luul/
鳞	lcyf/
麟	lclf/
凛	lxdu/
璘	lcwf/
赁	lvrb/
吝	lvwk/
潾	lcdf/
粼	lcmv/
嶙	lcuf/
遴	lczf/
瞵	lcof/
翷	lcmx/
𬴊	lcmf/
酪	lvyk/
落	lpck/
痨	libl/
铹	lijl/
嫪	lvnp/
荖	lxcl/
涞	lddl/
崃	ldul/
俫	ldrl/
嘞	likl/
棱	lfmw/
堎	lftw/
朗	lplo/
榔	lwme/
桹	lwml/
塱	lplt/
蒗	ldcl/
稂	lwhl/
㮾	lplm/
蓢	lpco/
立	ltwb/
理	lgwl/
粒	ltml/
梨	lbhm/
黎	lbhu/
戾	lthq/
藜	lbcu/
厘	lbil/
犁	lbhn/
笠	ltvl/
璃	lbwn/
厉	ltiw/
隶	ltyu/
骊	lbmd/
荔	ltcl/
俪	ltrd/
醴	lgyb/
砺	ltuw/
澧	lgdb/
鬲	geal/
罹	lbsv/
疠	ltbw/
俚	lgrl/
喱	lbkl/
篱	lbvn/
漓	lbdn/
浬	lgdl/
蓠	lbcn/
蠡	lghi/
唳	ltkq/
溧	ltdm/
蜊	lbid/
鲡	lbyd/
醨	lbyn/
粝	ltmw/
鹂	lbln/
黧	lbhh/
缡	lbsn/
傈	ltrm/
疬	ltbl/
跞	ltzl/
浰	ltdd/
雳	ltyl/
猁	ltqd/
篥	ltvm/
㰀	lbmu/
𫵷	ltul/
拦	lpfl/
澜	lpdj/
榄	lomj/
婪	lpmn/
罱	losg/
襕	lppj/
漤	lodn/
𬒗	lpuj/
陵	lnew/
翎	lnrx/
聆	lnes/
泠	lnds/
伶	lnrs/
苓	lncs/
羚	lnys/
呤	lwks/
瓴	lnrw/
鲮	lnyw/
舲	lnvs/
棱	lfmw/
酃	lnye/
柃	lnms/
〇	lnvv/
鸰	lnrn/
凉	lidx/
良	lidg/
粱	lidm/
椋	limx/
俍	lirl/
辌	liix/
𬜯	lucl/
镰	lvjj/
濂	lvdj/
殓	ladq/
琏	lpwi/
蔹	lpcw/
潋	ladw/
梿	lvmi/
浰	ltdd/
裣	lppq/
瑓	lawj/
𬶠	layj/
撂	llfk/
疗	lubl/
髎	lugp/
寥	lubp/
橑	lumx/
镣	lljx/
蹽	lmzx/
漻	ludp/
鹩	ludn/
咯	kmkk/
啰	lskx/
骡	llmx/
萝	llcx/
雒	lpwv/
蠃	llwi/
泺	lpdl/
荦	lpcn/
漯	lpdx/
捋	lsfc/
蓏	llcg/
裂	lqdy/
洌	lqdd/
趔	lqtd/
峛	lqud/
䴕	lqdn/
刘	lmwd/
琉	lmwi/
浏	lmdd/
榴	lmmt/
鎏	lmdj/
馏	lmut/
镏	lmjt/
锍	lzji/
珋	lzwe/
罶	lzst/
瑬	lmdy/
飗	lmft/
碌	lhuu/
鹠	lmpn/
栾	lowm/
銮	lowj/
峦	lowu/
娈	lown/
脔	lowr/
孪	lowz/
陇	lnel/
垄	lnlt/
砻	ljlu/
哢	lykc/
窿	ljbu/
昽	ljol/
弄	nywc/
漋	ljdu/
𬕂	lnvb/
䂮	ldfu/
陆	lhej/
露	lryk/
卤	lmbx/
虏	lmhl/
掳	lmfl/
庐	llgh/
橹	lmmo/
颅	llby/
泸	lldu/
赂	lhbk/
鲈	llyu/
菉	lhcu/
蕗	lhck/
漉	lhdl/
栌	llmu/
箓	lhvu/
琭	lhwu/
辘	lhil/
逯	lhzu/
鸬	llbn/
甪	lhpy/
轳	lliu/
勠	lhxl/
澛	lmdo/
稑	lhht/
𬬻	llju/
捋	lsfc/
履	lsuw/
缕	lssn/
侣	lsrk/
闾	lmmk/
膂	lsfo/
偻	lsrn/
稆	lshk/
罍	lrtf/
诔	ljyl/
酹	lkyc/
耒	ljfm/
缧	lrsx/
藟	ljct/
礌	lrut/
仑	lfrb/
溇	ladn/
剅	ladd/
𦝼	laon/
蟆	muid/
摩	megu/
闵	mxmw/
愍	mxmx/
湣	mxdo/
鳘	mxpy/
黾	mxkd/
忞	mcwx/
锚	mijt/
卯	mxpe/
茂	mvcw/
昴	mxoe/
峁	mxue/
铆	mxje/
懋	mvmx/
芼	mvcm/
茆	mice/
袤	mvym/
瞀	mvmo/
眊	mvom/
蝥	mimi/
懑	modx/
蒙	mfcu/
獴	myqu/
勐	myzl/
蠓	myiu/
甍	mfcw/
朦	mfou/
瞢	mfco/
幪	mfju/
艨	mfvu/
蜢	myim/
㠓	mfuu/
鹲	mfcn/
芒	mwcw/
氓	mwwm/
邙	mwwe/
牤	munw/
厖	mwip/
蜜	mtbi/
幂	mtbj/
芈	mgcf/
靡	mggf/
糜	mbgm/
醚	mbym/
祢	mbpx/
弭	mgge/
汨	mtdo/
宓	mtbb/
脒	mgom/
蓂	mtcl/
縻	mbgx/
洣	mgdm/
嘧	mtku/
漫	mady/
瞒	mpol/
谩	mayy/
镘	majy/
颟	mncy/
埋	mdtl/
𬜬	mack/
暝	mnol/
溟	mndl/
绵	mvsj/
勉	mpdl/
冕	mpoe/
沔	mpdg/
眄	maog/
勔	mpml/
湎	mpdm/
腼	mpom/
渑	mpdd/
眇	mlou/
藐	mlce/
缪	masp/
鹋	mucn/
磨	megu/
抹	mifw/
麽	megm/
默	mglq/
沫	mgdw/
摹	mecu/
殁	mgdu/
茉	mgcw/
漠	mgdd/
貊	mgvb/
蓦	mgcm/
瘼	mgbd/
耱	mglu/
无	wlay/
脉	mooy/
嫫	mend/
靺	mggw/
篾	mqvd/
牧	mhnw/
暮	mhco/
模	memd/
慕	mhcx/
幕	mhcj/
募	mhcl/
牡	mmnt/
呒	mlkw/
毪	mlmn/
𬭁	mmjm/
酶	mrym/
梅	mrmm/
媚	mkno/
媒	mrnm/
镅	mrjo/
郿	mrue/
浼	mjde/
袂	mkpg/
楣	mrmo/
鹛	mrun/
渼	mjdd/
瑂	mrwo/
糜	mbgm/
媄	mjnd/
嵋	mruo/
缪	masp/
呐	nikn/
镎	nuju/
臑	nvoe/
峱	niqu/
艿	nucn/
鼐	nono/
耏	ekep/
呢	nrkb/
溺	ntdg/
睨	ntoe/
伲	nbrb/
鲵	nbye/
旎	ngfb/
囡	nnkn/
蝻	noig/
甯	nwby/
泞	nwdd/
捻	npfx/
辇	npfi/
拈	nrfv/
廿	naca/
鲇	nvyv/
搦	npfg/
镊	nqjy/
颞	nqey/
臬	nqzm/
蘖	nqcm/
嗫	nqky/
菍	nqcx/
陧	nqet/
拗	avfl/
努	nmnl/
奴	nlny/
驽	nlnm/
孥	nlnz/
砮	nmnu/
胬	nmnr/
区	qhkx/
殴	oxqu/
瓯	oxqw/
𠙶	ozkl/
舥	plvb/
颦	pcvu/
牝	pvnb/
姘	phnk/
匏	pidb/
疱	pvbb/
湃	podf/
徘	pdrf/
砰	pcup/
硼	pfuo/
朋	pfoo/
膨	pfop/
芃	pfcf/
椪	pfmy/
堋	pfto/
淜	pfdo/
搒	bdff/
鳑	pwyf/
膀	bpof/
劈	pjud/
匹	pgke/
辟	btux/
丕	pjba/
疲	pbbp/
痞	pgbk/
坯	pjtp/
嚭	pgtk/
譬	ptuk/
噼	pjkx/
圮	pgtj/
邳	pjbe/
郫	pbpe/
伾	pjrp/
裨	btpu/
鼙	pbtu/
陴	pbeu/
甓	ptuw/
睥	ptou/
澼	ptdx/
枇	pbmb/
砒	pjub/
蚍	pbib/
纰	pjsb/
仳	pgrb/
鲏	pbyp/
䴙	ptun/
𬳵	pjmp/
叛	paby/
磐	ppvu/
槃	ppvm/
泮	padb/
襻	papu/
胖	pdob/
苹	pncp/
鲆	pnyp/
俜	perk/
洴	pndk/
泙	pndp/
荓	pnck/
骈	pvmk/
便	barg/
楩	pvmg/
扁	bphc/
㛹	pvng/
瓢	puxg/
剽	pmxd/
朴	pmmb/
殍	pldz/
蔈	plcu/
婆	pedn/
钷	pijk/
泊	bedb/
皤	pebt/
桲	bemz/
繁	fppx/
朴	pmmb/
䥽	ppjy/
蒲	plcf/
濮	pldf/
溥	pmdc/
瀑	phdu/
圃	pmkf/
镤	pljf/
镨	pmjo/
堡	bxrt/
菩	plck/
匍	plbf/
潽	pado/
脯	plof/
墣	pltf/
氆	pmmo/
旆	pkfj/
帔	pkjp/
霈	pkyj/
抔	pafb/
禽	qcrn/
衾	qhry/
芹	qccj/
溱	qcdh/
嗪	qckh/
芩	qccv/
揿	qvfq/
梣	ismv/
慬	qcxw/
螓	qcih/
锓	qxjy/
檎	qcmn/
吣	qvkx/
棋	qbmb/
漆	qjdu/
弃	qtwc/
欺	qjcq/
岂	qguj/
砌	qtud/
琪	qbwb/
契	qtfd/
淇	qbdb/
泣	qtdl/
琦	qbwk/
栖	qjmx/
乞	qgpv/
祁	qbpe/
戚	qjwx/
祇	qbpu/
炁	qtwh/
汽	qtdq/
柒	qjdm/
沏	qjdd/
祈	qbpj/
祺	qbpb/
讫	qtyv/
岐	qbuv/
蕲	qbcj/
崎	qbuk/
杞	qgmj/
萁	qbcb/
嘁	qjkx/
凄	qjdn/
碛	qtub/
畦	qbtt/
綦	qbcx/
亓	qbaw/
耆	qblo/
玘	qgwj/
埼	qbtk/
憩	qtux/
跂	qbzv/
芪	qbcu/
棨	qghm/
葺	qtce/
蹊	xjzd/
颀	qbjy/
汔	qtdv/
圻	qbtj/
磜	qtuu/
萋	qjcn/
蛴	qbiq/
亟	jbla/
俟	stru/
郪	qjue/
稽	jjho/
缉	jjse/
鲯	qbyb/
䓫	qbck/
𨙸	qbve/
𬨂	qbiu/
氰	qnqo/
罄	qwtf/
蜻	qeio/
檠	qncm/
亲	qhlm/
庼	qwgy/
倩	qaro/
苘	qwck/
羟	quyj/
锖	qyjo/
樯	qimk/
镪	qyji/
襁	qupi/
蔃	qici/
欠	qadr/
铅	qrjk/
牵	qrdn/
迁	qrzq/
潜	qvdo/
嵌	qauq/
钳	qvjg/
钤	qvjv/
芡	qacq/
歉	qajq/
仟	qrrq/
搴	qrbu/
谴	qpyl/
汧	qrdk/
荨	xfcc/
愆	qrrx/
佥	qrra/
椠	qaim/
褰	qrby/
悭	qrxt/
蒨	qaco/
岍	qruk/
磏	qruj/
纤	xrsq/
掮	qvfo/
圲	qrtq/
伣	qarj/
𬘬	qaso/
翘	qlyx/
鞘	qlgo/
樵	qumh/
谯	quyh/
侨	qurl/
诮	qlyo/
橇	qmmm/
劁	qmrd/
峭	qluo/
硚	quul/
鞒	qugl/
雀	qdxv/
憔	quxh/
硗	qmuw/
惬	qqxj/
郄	qqxe/
裘	qmqy/
楸	qzmh/
璆	qmwp/
遒	qmzy/
泅	qmdr/
俅	qmrq/
鼽	qmzj/
赇	qmbq/
龟	gtdd/
蚯	qziq/
蝤	qmiy/
鹙	qzhn/
訄	qmjk/
犰	qmqj/
巯	qmji/
𨱇	qmjq/
拳	qoju/
醛	qoyw/
颧	qocy/
铨	qojw/
痊	qobw/
辁	qoiw/
棬	qdmv/
鳈	qoyu/
邛	qkge/
銎	qkgj/
䓖	qkcl/
榷	qdmv/
阕	qdmt/
碏	qduo/
埆	qdty/
𬒈	qdxu/
娶	qsen/
趋	qhte/
躯	qhuq/
蘧	qmcu/
袪	qhpq/
胠	qhoq/
朐	qmoj/
劬	qmjl/
阒	qfmq/
苣	jfcj/
戌	xhwa/
鸲	qmjn/
焌	jrhw/
蠼	qmiy/
氍	qmom/
坥	qhtq/
灈	qmdv/
蛐	qhiq/
磲	qmum/
竘	qslj/
䓛	qhci/
拤	qcfb/
仁	rsre/
衽	ropw/
仞	rorr/
讱	royr/
纴	rosw/
荏	rocw/
蒻	rpcg/
鄀	rpce/
戎	rjgu/
蓉	rjcg/
茸	rjce/
濡	rlde/
褥	rhpc/
襦	rlpe/
蓐	rhcc/
洳	rhdk/
蠕	rlie/
溽	rhdc/
薷	rlce/
芮	rfcn/
蕤	rwcu/
糅	ramm/
潵	smdw/
挲	ssdu/
璱	siwb/
颡	spyy/
思	sjtx/
嗣	stkk/
巳	stkv/
嘶	sjkj/
俟	stru/
笥	stvk/
汜	stds/
咝	sjks/
伺	strk/
鸶	sjsn/
涘	stdu/
缌	sjsx/
澌	sjdj/
蛳	sjij/
飔	sjfx/
㟃	sjuk/
楒	sjmx/
毵	snsm/
唆	sskw/
溹	sldx/
葰	jrcw/
唢	slkb/
嗍	ssko/
莎	ulcu/
挲	ssdu/
桫	ssmu/
耸	snre/
嵩	skuk/
讼	syyg/
凇	skdg/
𪨊	sjur/
忪	skxg/
诉	shyi/
肃	shyb/
稣	sayh/
谡	shyw/
愫	shxx/
涑	shdu/
窣	sabu/
傃	shrx/
鹔	shyn/
蹜	shzb/
僳	shrm/
隋	sweo/
燧	sfhu/
尿	nluu/
隧	sfeu/
邃	sfzu/
眭	stot/
𫟦	sfiu/
嗽	srkq/
蒐	sxcg/
嗾	szku/
擞	szfw/
锼	sxjy/
塌	tltx/
拓	tpfu/
牠	tlny/
趿	tlzj/
闼	timd/
蹋	tizx/
阘	timx/
褟	tlpx/
鿎	duud/
涛	tqdc/
洮	tidv/
滔	tqdj/
焘	tqfh/
梼	timc/
叨	tqkd/
绹	tisf/
啕	tikf/
𫘦	timf/
肽	toot/
邰	tdse/
薹	tdct/
酞	toyt/
炱	tdsh/
滕	tfou/
縢	tfox/
螣	tfoi/
䲢	tfoy/
烫	tddh/
棠	twxm/
淌	tpdk/
塘	twtk/
樘	twmt/
傥	tprx/
镋	tpjx/
螗	twik/
鄌	twge/
铴	tujp/
䣘	twxe/
剔	tjod/
蹄	tbzj/
惕	ttxw/
嚏	ttkz/
鹈	tbbn/
擿	tjfg/
绨	ttsd/
荑	tbcy/
倜	ttrk/
逖	ttzh/
鳀	tbyz/
𫘨	tbmz/
探	tafm/
坦	totd/
炭	tauh/
毯	tomh/
瘫	tnbv/
潭	tpdu/
镡	tpju/
惔	tpxh/
忐	toux/
倓	tprh/
澹	dadk/
锬	tpjh/
榃	tpmt/
磹	tpuu/
珽	twww/
渟	tndd/
蜓	tniw/
莛	tncw/
桯	temw/
颋	twzy/
侹	twrw/
烶	twhw/
舔	tpux/
忝	tptx/
湉	tvdu/
殄	tpdp/
沺	tvdt/
畋	tvtw/
淟	tpdb/
晪	tpob/
盷	tvoy/
蜩	tuik/
眺	tlov/
鲦	tuym/
迢	tuzk/
龆	tuvk/
驮	tlmd/
拓	tpfu/
侂	tsrq/
鼍	tlkd/
椭	tlmo/
柁	tlmb/
箨	tpvf/
柝	tpmi/
圫	tstq/
庹	tlgi/
𬶍	tlyb/
帖	tcjv/
煓	tdhe/
桐	tjmk/
僮	tjrl/
仝	tjrg/
潼	tjdl/
烔	tjhk/
橦	tjml/
洞	dydk/
峒	dyuk/
曈	tjol/
哃	tjkk/
鲖	tjyk/
峂	tjud/
𦒍	tjlx/
兔	thdd/
屠	tluo/
菟	thct/
凃	tldm/
稌	tlhm/
葖	tacq/
𬳿	tlmm/
煺	tfhg/
暾	tgow/
饨	tfut/
坉	tftt/
鲨	uldy/
煞	uidh/
刹	ulxd/
唼	uikn/
挲	ssdu/
稍	uqho/
劭	uvdl/
潲	uvdo/
芍	uicu/
筲	uqvo/
召	vvdk/
柖	uimk/
折	vefj/
赦	uiiw/
奢	urdo/
佘	ueru/
歙	uirq/
畲	urrt/
滠	uidy/
厍	uiii/
拾	ubfk/
猞	urqg/
𪨶	urui/
什	ubru/
渗	uodp/
侁	uere/
莘	uecx/
瘆	uobp/
甡	ueuu/
谌	isyb/
椹	uomb/
矧	uoul/
呻	ueku/
绅	uesu/
谂	uoyx/
胂	uoou/
葚	uocb/
鲹	ueyp/
娠	ueni/
棽	iemv/
𬳽	ueme/
昇	ucoc/
晟	ifoi/
甥	ucul/
眚	uyuo/
乘	ifqr/
嵊	ufur/
赏	upxb/
裳	uuxy/
觞	uudp/
垧	uptk/
诗	ujyc/
石	ubak/
试	utyg/
饰	utuj/
实	ubbd/
氏	utpv/
士	utua/
施	ujfy/
失	ujpf/
尸	ujkp/
识	ubyv/
矢	ugpd/
嗜	utko/
谥	utym/
誓	utfk/
释	utcf/
恃	utxc/
仕	utrt/
侍	utrc/
逝	utzj/
豕	ugau/
蚀	ubui/
噬	utkr/
匙	ibob/
拭	utfg/
祏	ubpu/
奭	utdb/
莳	utcc/
驶	ugmu/
似	strr/
舐	utuu/
筮	utvr/
湜	ubdz/
栻	utmg/
螫	utii/
贳	utub/
蓍	ujco/
什	ubru/
酾	ujyd/
媞	utnz/
鼫	ubju/
鸤	ujun/
嘘	xhky/
鲺	ujyi/
殖	vbdq/
峙	vtuc/
襫	utpb/
浉	ujdj/
埘	ubtc/
䏡	utou/
䴓	ujbn/
𫚕	ujyj/
𬤊	utyz/
杉	unmp/
煽	unhx/
膻	daod/
骟	uamx/
赡	uabk/
讪	uayu/
禅	ippu/
剡	uahd/
鳝	uayk/
鄯	uaye/
芟	uncu/
姗	unnc/
晱	uooh/
潸	undo/
烻	unhv/
单	dnbu/
栅	vimc/
墡	uatk/
𫮃	uatu/
衰	ugyv/
泷	ljdl/
鹴	uwyn/
漴	ijdu/
槊	upnm/
妁	upnu/
闩	udma/
树	uhmc/
术	uhmd/
叔	uauy/
梳	uami/
孰	ulww/
署	umso/
塾	ulwt/
恕	uhnx/
庶	uhgh/
戍	uhwd/
漱	uhdq/
殊	uadw/
殳	uajy/
曙	umoo/
枢	uamq/
菽	uacy/
蔬	uaci/
澍	uhdc/
倏	uarq/
墅	uhlt/
腧	uhod/
摅	uafx/
纾	uasy/
秫	ulhu/
沭	uhdu/
婌	ulny/
陎	uaew/
毹	uarm/
鄃	uare/
𬬸	uhju/
说	usyx/
瘦	urby/
守	uzbc/
兽	urbk/
授	urfy/
札	vumv/
闸	vumj/
栅	vimc/
咤	vikq/
揸	vlfd/
鲊	vmyv/
楂	vlmd/
喳	vlkd/
霅	viyk/
拃	vmfv/
咋	zmkv/
溠	vidg/
哳	vlkj/
奓	vldx/
蚱	viiv/
馇	ilud/
挓	vlfq/
喋	dskm/
䃎	viux/
鲝	vmyy/
昭	vqok/
着	vryo/
沼	vxdk/
曌	vvog/
旐	vvfv/
𬬿	vqjk/
𬶐	vvyv/
宅	vdbq/
寨	vobm/
祭	jtxu/
择	zeff/
瘵	vobu/
哲	vefk/
蛰	vefi/
辙	veiw/
赭	vlio/
晢	vefo/
詟	velk/
䗪	vigi/
帧	vejb/
针	veju/
诊	voyp/
鸩	vobn/
赈	vobi/
疹	vobp/
榛	vemh/
桢	vemb/
胗	veop/
畛	votp/
禛	vepb/
鬒	voeb/
瑧	vewh/
葴	veck/
蓁	vech/
揕	vofb/
袗	vopp/
纼	vosl/
郑	vfbe/
筝	vcvy/
铮	vcjy/
拯	vyfi/
峥	vcuy/
诤	vfyy/
彰	vulp/
鄣	vule/
瘴	vdbu/
漳	vudu/
樟	vumu/
幛	vdju/
仉	vprj/
暲	vuou/
知	vjuk/
治	vtdk/
支	vjuy/
致	vtgw/
汁	vjdu/
置	vtsq/
智	vtuo/
执	vbfw/
掷	vtfe/
织	vjsv/
植	vbmq/
跖	vbzu/
滞	vtdj/
秩	vthf/
旨	vgbo/
侄	vbrt/
徵	vgrw/
栀	vjmv/
芷	vgcv/
址	vgtv/
雉	vtuv/
窒	vtbt/
肢	vjov/
陟	vteu/
痔	vtbc/
沚	vgdv/
栉	vtme/
稚	vthv/
卮	vjiv/
挚	vtfu/
郅	vtge/
殖	vbdq/
畤	vttc/
峙	vtuc/
絷	vbfx/
摭	vbfh/
蛭	vtit/
鸷	vtfn/
铚	vtjt/
蜘	vjik/
踬	vtzb/
祉	vgpv/
埴	vbtq/
帜	vtjv/
豸	vtpp/
贽	vtfb/
锧	vtjb/
骘	vtem/
踯	vbze/
桎	vtmt/
滍	vtdi/
黹	vgyx/
跱	vtzc/
忮	vtxv/
稙	vjhq/
疐	vtuz/
识	ubyv/
禔	vjpz/
胝	vjou/
晊	vtot/
庤	vtgc/
梽	vtmx/
榰	vjmo/
𬃊	vtmb/
詹	vndk/
栈	vamj/
毡	vnmv/
湛	vadb/
辗	voiy/
飐	vofv/
崭	vouj/
栴	vnmd/
谵	vnyk/
搌	vofy/
𫗴	vnud/
妆	vwln/
壮	velt/
戆	velx/
拙	vsfi/
酌	vlyu/
叕	vlyy/
擢	vlfv/
濯	vldv/
焯	iqhu/
涿	vsdu/
浞	vldz/
棁	vsmx/
䓬	vlcu/
䦃	vsjo/
𬸦	vlfn/
馔	vcug/
颛	vduy/
僎	vcrg/
仲	vyrv/
盅	vkvm/
锺	vkjv/
舯	vkvv/
朱	vapw/
助	vhql/
驻	vhmv/
诛	vayw/
株	vamw/
渚	vmdo/
箸	vhvo/
邾	vape/
铢	vajw/
蛀	vhiv/
洙	vadw/
炷	vhhv/
茱	vacw/
竺	vlve/
伫	vhrv/
苎	vhcv/
麈	vmlv/
槠	vamo/
舳	vlvy/
疰	vhbv/
杼	vhmy/
侏	varw/
翥	vhlx/
柷	vhmx/
躅	vlzi/
蠋	vlii/
橥	vaqm/
术	uhmd/
瘃	vlbu/
𬣞	vmyv/
骓	vtmv/
缒	vfsl/
洲	vxdv/
皱	vrdp/
昼	vrid/
酎	vryc/
诌	vxye/
绉	vrse/
辀	vxiv/
啁	vqkk/
鸼	vxvn/
赒	vxbk/
妯	vany/
娲	wlnn/
畖	wltg/
玟	wsww/
汶	wodw/
炆	wshw/
辒	weim/
刎	wowd/
阌	wsmy/
紊	wowx/
榅	wemm/
芠	wscw/
鳁	weym/
𫘜	wsmw/
蕹	wfcv/
鹟	wcgn/
忘	wdwx/
亡	wwwv/
妄	wdwn/
罔	wpkw/
弯	wnwg/
腕	waov/
剜	wnbd/
皖	woby/
宛	wobv/
豌	wndv/
纨	wpsw/
莞	wocy/
脘	wooy/
婠	wnnl/
琬	wowv/
芄	wpcw/
塆	wntg/
𬇕	wadw/
涡	wpdn/
渥	wgdt/
偓	wgrt/
蜗	wpin/
硪	wguw/
涴	yddv/
误	whyt/
乌	wapa/
唔	wlkk/
雾	whyl/
呜	wakw/
午	wmpu/
兀	whae/
巫	wagr/
务	whwl/
恶	eiyx/
邬	wawe/
诬	wayr/
寤	whbk/
庑	wmgw/
侮	wmrm/
忤	wmxw/
鹜	whmn/
梧	wlmk/
晤	whok/
骛	whmm/
杌	whmw/
鹀	wlgn/
鼯	wljk/
圬	watk/
妩	wmnw/
洿	wadk/
珷	wmwv/
芴	whcw/
鋈	whdj/
屼	whuw/
鹉	wmyn/
珸	wlwk/
牾	wmnk/
仵	wmrw/
峿	wluk/
𣲘	wmdw/
微	wirj/
喂	wkky/
伪	wjrw/
唯	wrkv/
围	wrkw/
委	wjhn/
畏	wkty/
煨	wihy/
隈	wiey/
炜	wjhw/
慰	wkux/
尉	wkuc/
苇	wjcw/
萎	wjcn/
蔚	wkcc/
纬	wjsw/
鲔	wjyo/
玮	wjww/
渭	wkdo/
帏	wrjw/
巍	wiug/
猬	wkqo/
薳	wjcy/
鳚	wkyc/
潍	wrdv/
亹	wjwq/
偎	wiry/
闱	wrmw/
诿	wjyn/
隗	wjeg/
溦	widj/
沩	wrdw/
硙	wkuj/
崴	wuun/
煟	wkho/
逶	wizn/
碨	wkuy/
琟	wrwv/
峗	wruv/
螱	wkui/
鳂	wiyy/
𬀩	wjow/
𬱟	wjdy/
𬶏	wryv/
薪	xhcj/
欣	xhjq/
鑫	xhjj/
歆	xhlq/
镡	tpju/
囟	xvpx/
伈	xxrx/
莘	uecx/
奚	xjvd/
惜	xjxo/
悉	xjcx/
溪	xjdd/
曦	xjok/
玺	xgdy/
熄	xjhx/
汐	xjdx/
熙	xjih/
嘻	xjkk/
檄	xbmw/
铣	xgje/
晞	xjoj/
犀	xjun/
禧	xgpk/
豨	xjuj/
烯	xjhj/
隰	xbeh/
郤	xtge/
羲	xjyk/
谿	xjvg/
郗	xjxe/
牺	xjnx/
歙	uirq/
僖	xjrk/
咥	xtkt/
禊	xtpd/
翕	xjrx/
熹	xjth/
觋	xbgj/
皙	xjmb/
枲	xgsm/
嶲	xjuk/
饩	xtuq/
醯	xjym/
憙	xgtx/
唏	xjkj/
舄	xtjh/
浠	xjdj/
舾	xjvx/
蹊	xjzd/
傒	xjrd/
螅	xjix/
肸	xjou/
屣	xguz/
觿	xjdk/
酅	xjue/
穸	xjbx/
屃	xtub/
蓰	xgcz/
潟	xtdh/
鳛	xbyb/
裼	xjpw/
鼷	xjjd/
阋	xtme/
绤	xtsg/
樨	xjmn/
爔	xjhk/
粞	xjmx/
巇	xjug/
俙	xjrj/
菥	xjcj/
恓	xjxx/
饻	xjuy/
𠅤	xbwx/
𫘬	xbmd/
𬭳	xgjk/
形	xnkp/
兴	xwxb/
邢	xnke/
刑	xnkd/
腥	xeou/
饧	xnup/
骍	xemx/
婞	xwng/
惺	xexu/
荥	xncu/
悻	xwxg/
钘	xnjk/
硎	xnud/
𫰛	xnnj/
乡	xyvp/
橡	xemu/
巷	xegs/
湘	xydo/
祥	xipy/
详	xiyy/
襄	xyyf/
庠	xigy/
骧	xymf/
瓖	xywf/
鲞	xujy/
珦	xewk/
葙	xyco/
𬙋	xysf/
咸	xvwk/
限	xaeg/
献	xauq/
陷	xaej/
衔	xvrj/
氙	xrqu/
酰	xrye/
腺	xaou/
娴	xvnm/
羡	xayq/
霰	xayw/
纤	xrsq/
籼	xrmu/
涎	xvdv/
岘	xauj/
苋	xacj/
狝	xpqx/
筅	xpve/
燹	xpuh/
洗	xgde/
暹	xrzv/
缐	xasu/
猃	xpqq/
痫	xvbm/
伭	xvrx/
跹	xrzq/
莶	xrcq/
挦	xvfc/
孅	xrnj/
鹇	xvmn/
禒	xppu/
㬎	xpoh/
𪾢	xaoj/
𫍯	xvyk/
𬸣	xrbn/
削	xmxd/
筱	xlvw/
骁	xmmw/
咲	xlkt/
崤	xuuo/
枵	xmmk/
啸	xlkb/
潇	xmdb/
嚣	xmkk/
虓	xmjj/
淆	xudo/
皛	xlbb/
哮	xlkz/
洨	xudf/
哓	xmkw/
涍	xldz/
滧	xldw/
蟏	xmib/
敩	xlxw/
𫍲	xlyy/
邪	xsye/
卸	xqve/
挟	xsfj/
泻	xqdy/
协	xsub/
泄	xqdu/
偕	xsrb/
谐	xsyb/
胁	xsob/
解	jcdn/
榭	xqmc/
楔	xkmd/
亵	xqyw/
绁	xqsu/
撷	xsfy/
絜	jsfx/
廨	xqgn/
渫	xqdm/
偰	xqrd/
瀣	xqdj/
揳	xkfd/
薢	xqcn/
躞	xqzy/
榍	xqmo/
㙦	xsrt/
𬹼	xqvj/
咻	xzkm/
脩	xzro/
滫	xzdo/
珛	xowo/
馐	xzui/
鸺	xzrn/
宣	xdbd/
璇	xowz/
渲	xcdd/
玹	xowx/
烜	xshd/
漩	xodz/
瑄	xdwd/
券	qcjd/
眩	xcox/
咺	xdkd/
儇	xdry/
晅	xsod/
翾	xdsx/
琄	xcwo/
痃	xobx/
暶	xooz/
𫍽	xdyy/
𫓶	xdjo/
𫠊	xomx/
汹	xpdx/
诇	xhyk/
谑	xdye/
茓	xicb/
峃	xixu/
叙	xfry/
绪	xfso/
圩	wrty/
诩	xsyx/
吁	yfky/
婿	xfno/
煦	xfoh/
媭	xhpn/
勖	xfol/
蓿	xhcb/
盱	xhoy/
顼	xhwy/
糈	xsmo/
欻	xhhq/
洫	xfdm/
湑	xfdo/
畜	xfxt/
醑	xsyo/
浒	hmdw/
魆	xhgl/
珝	xswx/
㳚	xfdd/
𦈡	xhse/
𬣙	xhyy/
匣	xckj/
辖	xcik/
叚	xcuy/
暇	xcoy/
狎	xcqj/
硖	xcuj/
厦	uiiw/
巡	xfzv/
薰	xgch/
询	xfyo/
迅	xrzu/
洵	xfdo/
徇	xrro/
蕈	xrcu/
浔	xfdc/
郇	xfbe/
鲟	xfyc/
荨	xfcc/
醺	xgyh/
栒	xfmo/
獯	xgqh/
汛	xrdu/
噀	xrkg/
浚	jrdw/
𫄸	xgsh/
𬍤	xfwc/
𬘓	xfsi/
𬩽	xfee/
哑	ymky/
鸦	ylyn/
衙	yurk/
轧	yiiv/
蚜	yuiy/
猰	yiqd/
琊	yuwe/
砑	yiuy/
讶	yiyy/
揠	yifn/
堐	yutt/
隐	yxex/
殷	yhpu/
尹	yxep/
寅	ycbb/
胤	yveo/
铟	yhjy/
洇	yhdy/
茵	yhcy/
鄞	ycce/
喑	yhko/
垠	yctg/
窨	yvbo/
禋	yhpt/
嚚	yckk/
訚	ycmk/
龂	ycvj/
崟	ycuj/
慭	yvlx/
夤	ycxb/
溵	yhdu/
狺	ycqk/
蟫	yciu/
吲	yxkl/
硍	ycug/
歅	yhxq/
䲟	yvye/
𬤇	yhyt/
𬮱	yhmt/
姚	yinv/
幺	yqvs/
曜	yvov/
谣	yiyf/
遥	yizf/
吆	yqky/
窈	yxbl/
肴	yixo/
窅	yxbo/
鹞	yvvn/
铫	yijv/
珧	yiwv/
疟	ndbe/
靿	yvgl/
侥	jlrw/
崾	yvun/
媱	yinf/
㙘	yqtn/
野	ylly/
噎	yrkb/
掖	yifw/
谒	yiyr/
冶	yldk/
晔	yiou/
腋	yiow/
咽	yaky/
揶	yefe/
痒	ypby/
漾	yddy/
佯	ywry/
烊	ywhy/
飏	ywfp/
炀	ywhp/
羕	ydyy/
疡	ywbp/
鸯	yuyn/
恙	ydyx/
咉	yuky/
意	ytlx/
依	yjry/
衣	yjwy/
医	yjku/
异	ytsc/
裔	ytyk/
益	ytbm/
邑	ytkb/
役	ytru/
夷	ybar/
疑	ybbz/
倚	ygrk/
忆	ytxv/
遗	ybzb/
议	ytyy/
噫	yjkx/
奕	ytwd/
怡	ybxk/
溢	ytdm/
驿	ytmf/
疫	ytbu/
胰	yboy/
刈	ytxd/
颐	ybiy/
毅	ytlu/
钇	ygjv/
懿	yttx/
诣	ytyo/
彝	ybhc/
揖	yjfe/
弋	ytyd/
轶	ytif/
羿	ytxc/
祎	yjpw/
镒	ytjm/
贻	ybbk/
佚	ytrf/
谊	ytyq/
燚	ythh/
弈	ytwc/
咿	yjky/
扆	yghy/
镱	ytjx/
佾	ytro/
浥	ytdb/
臆	ytox/
瘗	ytbt/
缢	ytsm/
沂	ybdj/
峄	ytuf/
圯	ybts/
绎	ytsf/
熠	ythb/
迤	ybzy/
劓	ytzd/
翌	ytxl/
埸	yttw/
漪	yjdk/
苡	ygcr/
饴	ybuk/
嶷	ybuz/
屹	ytuv/
肄	ytby/
挹	ytfb/
裛	ytyb/
潩	ytdg/
舣	ygvy/
怿	ytxf/
踦	ygzk/
螠	ytim/
嗌	aokm/
簃	ybvx/
薏	ytcx/
洢	yjdy/
荑	tbcy/
旖	ygfk/
悒	ytxb/
嫕	ytnx/
鹢	ytbn/
勚	ytul/
呓	ytkv/
眙	ybok/
蜴	ytiw/
廙	ytgg/
枍	ytmk/
癔	ytbx/
杙	ytmy/
宧	ybbi/
扅	ybhx/
㑊	ytrb/
𫄷	ytsx/
𫖮	yguy/
𬟁	ytcn/
𬬩	ytjy/
𬺈	ygvk/
沿	ypdk/
颜	ypwy/
岩	ypuu/
炎	yphh/
彦	yawp/
阎	ypmj/
艳	yafb/
闫	ypms/
焰	yahj/
淹	yndd/
晏	yaon/
雁	yaiv/
鄢	ynve/
阏	ynmd/
嫣	ynnh/
檐	ypmk/
偃	yorn/
衍	yord/
砚	yauj/
魇	yoig/
甗	yohw/
筵	ypvv/
赝	yaib/
弇	yorc/
湮	yndt/
酽	yayy/
琰	yowh/
堰	yatn/
郾	yoke/
滟	yadb/
沇	yody/
芫	yocy/
谚	yayp/
黡	yoih/
胭	ynoy/
唁	yakk/
渰	yodc/
墕	ynth/
棪	yomh/
戭	yobg/
掞	yafh/
蝘	yoin/
鼹	yojn/
崦	ynud/
厣	yoij/
漹	yndh/
䶮	yolt/
觃	yajz/
𪩘	youq/
𫄧	ypsv/
𬙂	yosb/
𬸘	yokn/
营	ynck/
嬴	ynwn/
嘤	yekn/
瑛	yewy/
映	ywoy/
莺	yecn/
萤	ynci/
婴	yebn/
莹	yncy/
颍	ywby/
媵	ywon/
膺	yego/
楹	ynmm/
萦	yncx/
荧	ynch/
罂	yebf/
滢	yndy/
荥	xncu/
潆	yndx/
蓥	yncj/
溁	yndm/
茔	ynct/
媖	yeny/
䓨	yecf/
愿	ycix/
员	yokb/
园	yoky/
渊	yddl/
垣	yotd/
鼋	yoyd/
沅	yody/
媛	yony/
掾	ycfu/
塬	yotx/
鸳	ydxn/
嫄	yonx/
辕	yoiy/
芫	yocy/
涴	yddv/
垸	ycty/
蜎	ydio/
眢	ydxo/
箢	ydvv/
羱	yoyx/
𫘪	yomx/
涌	yndy/
佣	ykry/
壅	ykwt/
甬	ynsy/
饔	ykwg/
鄘	ykge/
澭	ykdv/
墉	ykto/
喁	yjkd/
恿	ynsx/
埇	ynty/
鲬	ynyy/
曰	yuka/
乐	lipx/
樾	ydml/
哕	hfkx/
钥	ydjo/
𬸚	ydqn/
雨	ysad/
预	yfyy/
瑜	ymwd/
御	yfre/
逾	ymzd/
愈	yfrx/
俞	ymrd/
渔	ymdy/
豫	yfyu/
愚	ymtx/
渝	ymdd/
裕	yfpg/
育	yfwo/
瘀	yhbd/
浴	yfdg/
彧	yfga/
鹬	yfmn/
峪	yfug/
誉	yfxk/
欤	ymyq/
谕	yfyd/
榆	ymmd/
鬻	yfgg/
煜	yfhl/
毓	yfpi/
阈	yfma/
圉	yskg/
聿	yfyg/
吁	yfky/
钰	yfjy/
瑀	yswy/
鄅	ysye/
庾	ysgr/
愉	ymxd/
盂	ymym/
屿	ysuy/
迂	yhzy/
禺	ymtd/
遹	yfzk/
淯	yfdo/
妤	ymny/
窳	ysbg/
纡	yhsy/
妪	yfnq/
鹆	yfgn/
俣	ysrt/
喁	yjkd/
燠	yfhd/
雩	ymyk/
腴	ymor/
舁	ymjc/
谀	ymyr/
矞	yfmk/
敔	ysww/
熨	yruh/
潏	yfdk/
堉	yfto/
嵛	ymud/
圄	yskk/
艅	ymvm/
揄	ymfd/
萸	ymcr/
臾	ymjr/
褕	ympd/
燏	yfhk/
髃	ymgd/
瘐	ysbr/
觎	ymrj/
龉	ysvk/
尉	wkuc/
蔚	wkcc/
狳	ymqm/
伛	ysrq/
蝓	ymid/
蓣	yfcy/
㺄	ysqd/
蕴	yrcm/
昀	yfoy/
妘	yfny/
韫	yrwm/
恽	yrxi/
氲	ygqm/
缊	yrsm/
郓	yrbe/
耘	yfly/
筼	yfvb/
沄	yfdy/
纭	yfsy/
涢	yfdb/
员	yokb/
馧	yghm/
𫖳	ygyy/
游	yadz/
呦	yxkl/
友	yzuy/
鼬	yrjy/
佑	yrrk/
邮	yaye/
幼	yryl/
酉	yzxa/
悠	yxrx/
诱	yryn/
宥	yrbo/
鱿	yayy/
攸	yxrw/
囿	yrko/
卣	yzbk/
侑	yrro/
铕	yzjo/
猷	yabq/
牖	yzpf/
莠	yzcn/
羑	yzyj/
莜	yacw/
黝	yzll/
莸	yacy/
耰	yxlw/
槱	yzmh/
蝤	qmiy/
浟	yadw/
蝣	yaiz/
匝	zlkj/
拶	zofx/
遭	zqzo/
燥	zvhm/
躁	zvzm/
唣	zvkq/
𥖨	zvum/
哉	zbgk/
栽	zbgm/
灾	zbbh/
责	zefb/
咋	zmkv/
箦	zevb/
赜	zeib/
舴	zevv/
甑	zfbw/
曾	cfbo/
鄫	zcbe/
罾	zcso/
综	zksu/
䎖	zcbx/
藏	cwci/
奘	zdpd/
姿	zjdn/
滋	zjdy/
渍	ztdb/
梓	zgmx/
咨	zjdk/
恣	ztdx/
赀	zjvb/
訾	zgvk/
笫	zgvd/
粢	zjdm/
吱	vjkv/
孳	zjbz/
觜	zjvy/
孜	zjzw/
淄	zjdt/
耔	zglz/
鼒	zjco/
虸	zgiz/
锱	zjjt/
鄑	zjye/
錾	zaij/
拶	zofx/
昝	zowo/
佐	zlrg/
唑	zpkr/
胙	zpov/
捽	zlfu/
岞	zpuv/
综	zksu/
粽	zymu/
疭	zybr/
枞	ckmr/
偬	znrx/
珇	zmwq/
咀	jskq/
鲰	zxyy/
鄹	zxee/
